=index.jsp
login=login.html
logout=LogoutServlet
Signup=signup.html
ShowCategory=category.jsp
ShowCar=car.jsp
ShowHistory=history.jsp
CreateCategory=createcategory.jsp
CreateCar=createcar.jsp
Cart=orderCart.jsp
History=history.jsp
ActiveCode=activecode.html
SendActiveCodeProcess=SendActiveCodeServlet
SendMailProcess=SendMailServlet
ActiveAccountProcess=ActiveAccountServlet
ShowHistoryDetailProcess=ShowHistoryDetailServlet
CheckValidCodeProcess=CheckValidCodeServlet
DeleteOrderProcess=DeleteOrderServlet
AddDiscountCodeProcess=AddDiscountCodeServlet
CheckOutCartProcess=CheckOutCartServlet
UpdateCartAmountProcess=UpdateCartAmountServlet
DeleteCartProcess=DeleteCartServlet
AddToCarProcess=AddToCarServlet
GetCarProcess=ShowCarDetailServlet
UpdateCarProcess=UpdateCarServlet
CreateCategoryProcess=CreateCategoryServlet
CreateCarProcess=CreateCarServlet
LoginProcess=LoginServlet
LogoutProcess=LogoutServlet
SignUpProcess=SignUpServlet